Last Name	First Name
Staller	Lauren
Gardner	Madison
Koduru	Aarna
Batty	Haleigh
Hillenbrand	Alyssa
Shantharam	Samhita
Lee	Ricky
Prox	Jack
Price	Jake
Ray	Samuel
Combs	Jackson
Flak	Ethan
Hayes	Ryland
Sherey	Thomas
Moorhead	Conor
Halfhill	Skyler
Arthur	Jackson
Karkalik	Brayden
Dorsey	Will
Ransom	Emmett
Nassey III	Michael
Gilmore	RJ
Tanoos	Michael